//MAP CONVERTED BY dmm2tgm.py THIS HEADER COMMENT PREVENTS RECONVERSION, DO NOT REMOVE
"a" = (
/turf/open/floor/plating,
/area/template_noop)
"b" = (
/obj/structure/table,
/turf/open/floor/plating,
/area/template_noop)
"c" = (
/obj/structure/tank_dispenser,
/turf/open/floor/plating,
/area/template_noop)
"d" = (
/obj/structure/bed,
/turf/open/floor/plating,
/area/template_noop)

(1,1,1) = {"
a
a
c
"}
(2,1,1) = {"
a
a
d
"}
(3,1,1) = {"
a
a
b
"}
(4,1,1) = {"
a
b
b
"}
